100010110111100
111111001011101
001001001000111
000000001111001
011111110111000
100110110011100
011011011101100
110111101010011
100111001111101
100010100000111
110011100011001
111001011111110
000000110000110
111100010001001
111001111101011