100100010111000
101111001110110
000111101100001
001000111000111
011010000101100
111010110100111
011100010111100
110011001101111
010111111001100
001110011110100
010110011110110
010000001111110
000111100010101
100100111101011
110101101001000