110001011000101
010011000100100
111111011011101
111110110111011
101001000010110
111111111111101
111011000110001
110011101101101
111100000011001
000000011111001
000111111101000
000001000011010
001010101011100
001100010001101
010001010011010