110111111111100
111101110111111
010011001100101
101010001111001
010011100011101
000101011101010
100000111000010
010011101010100
000101100001100
100011010101000
110001000000001
110010100010000
100111111110100
111110000100001
010110101100110