101101000110011
110010111101011
100111011010100
010100110110101
100011111111011
100111000011100
010100010111100
001111101010111
001101010101111
000110000101100
110011101010011
100100110111011
001000110110101
100000100001101
101010010010100