010010100111010
111101011100111
000100011001111
010110100100011
011110101000000
111000001011001
011001001111110
001111110001110
111101110100111
010111110110010
110011010100000
111100000100111
100001111001110
111010111011001
011111111111010