000110110011010
111000111110011
111010110110101
000010111010011
110011011011000
100000100111111
100011001110011
000101011001001
100000111100011
001111010001101
100111010101100
110011111111111
011101011100110
001110111110011
111111100110001