011111100110011
111001111111001
100111001011110
110111111100001
100000010101000
001100100001001
111010010010001
110101001000101
000101010001100
111010111111110
111101001110001
011010010100000
100110011111100
100001100011000
001101001011001