111111100111111
100110100101001
111101011000000
001011010010101
110011000011001
001011110110111
010110011111101
101010010010100
101110010101000
110011000000111
000001111000111
011111001011100
110110111101001
101011010100100
000110001001010