010100101101111
100000000110011
001011101101111
100110110100011
011001011111101
110011110111111
111100111111001
011110100100101
011000010010110
110101001011100
110011110101110
111011010011000
000111101110100
000111111001101
101001100100100