100101100110010
111010111000110
010101000000101
101000101010000
110000000111011
100110100010011
101011111000110
110010111101010
000001101100110
101111001000101
000011111111101
111110110011011
101011100101010
110101110001001
111011111000010