100100101001010
011110000110010
011111101110100
110000011011001
111011011011010
000100010001000
011010010110010
011011000111101
111111001010111
010011111101011
110100101011010
011001000000100
011011010101011
110110001011100
000110001100011