101111111101111
110000101110101
100101000001011
010101100111011
111100001010001
111011110101010
100001011110011
101101000000001
100000000001000
100101111011010
000101011111001
001000101101000
110100110011000
111100101011101
101011011101011