000001000011010
110001011100110
101101101101011
010111001000011
000111000001101
101110000111010
111110100101101
001111011011111
000110111101110
110010100011101
000000100110000
010110101011101
101110010111010
100010010001110
110010011001000