010111010001000
010111001010010
101111010011101
010011101110100
101111010101101
111011000000101
111010100011010
101011010011110
010001110000001
001000011011011
001111101000010
001010010100010
110111011110000
100011001010010
001101000001000