011011101110101
010111111011101
101000101000001
010111101100011
110010101111110
101101100011011
010011011000111
000011110111110
110110110110010
111111111101011
110100011010111
110011101100110
111101110000100
011111100110110
101000011111100