000000101001001
011100011101011
001110001100110
111001011010001
110100111111011
011011100101101
100111011110010
001001101110111
011001000111100
001100011101000
010010010000101
100101010110111
110110011101010
011010100101101
100110100001100