001110111000110
110110001000001
001001001000000
010010011110110
001111100111010
010010110011010
001001010000110
101111011000011
110110101100010
001101101101111
110101000010101
010110011010011
101100010101111
101000111000010
101111100010001