011001000010000
000010011110011
000100101000101
110011000000000
110111010100010
011110100010010
101011011011001
111110111100110
111101101010111
011011110111111
011100011101100
001011111001101
010010001100001
100110110110111
010000101100110