001000101100001
001110000110010
101001011101110
011110011111001
101001011111100
010010011001011
101110110100000
010110101011101
001111000001101
110001100111001
110100111111110
101010011010111
001110001110111
111111100100110
111100111001000