110001111101111
101110111011011
111011100011010
010100101011110
101100100101110
000110110011010
001011010000100
000000000110111
001010001010101
011100101010110
110001001101110
110000000000101
111101110011110
010101111100111
111010010101111