001111010101011
100011110111101
111111011100110
000000111011111
011101000110011
100000111011011
001000100111111
111001000111011
001011100100011
010001001101101
011001100010010
101101000001111
010110100100111
010011000111000
100111111110100