111010010110000
000101111111110
011110101101001
000101010101111
110110110111111
110010010111010
110100100000000
110010010010001
000010000100000
000111001010101
111110001110000
011000000010001
101101001011011
101010010011011
001111111111100