110000101000111
001100100001001
111101100011111
010110001100010
111111111001101
000111111000111
111101111001000
011000100100101
101000001111111
100101011111101
100001110110001
110100111110110
101101101100101
101111111101101
111000111110000