000010001001001
110000111011000
110000111100011
110100110100101
110110010010011
011011000010011
011000101000001
001010100111100
100001000011011
011100111111101
010111111011001
010101101110110
010111111101100
111000000110010
110101010011001