011110001101010
011100000111010
011001011110000
110010110100101
011011000111101
001110000111001
011001100110110
011010000101101
110000011000001
010100001101010
111011000101111
101011101100110
111111110111111
010011010001111
100101101101110