100101010110101
111101111110111
100101010100101
011000111101101
011111011111001
001110101101001
101010110011101
010110001100010
010110111110000
110100000010111
000001001011000
100100110000010
101000100000101
111100101001011
000101001011101