100100101011111
111001100000000
111111010001001
110101101111110
011101010111111
000000011101111
010101111110001
011110010011111
000010110001001
010011000101000
001000110100000
110011110001111
100101111111111
111101011101011
110000010011001