011011000010000
001100011110011
000101101110110
011011011111110
110110001100010
111011111110000
111111110011101
100110111000111
001000101111100
001101101011011
100111001001100
110001001111101
001111011010010
000001100000110
010001010000101