101000010100101
111101101111010
011110111000011
011010010001110
000010101100100
101100101000000
001000101001001
000011100010010
111111111000001
111111011001001
000101111000111
111101000000010
011010101001101
001111101110111
000110110110101