100001000011001
011010000001001
101101110110010
000110100011111
101110110101101
110010001001100
111100110010101
011011010011111
011010111010100
110100010111101
001011010010010
101101000101101
011111000001000
101110001100101
011011101011110