101110010000001
111000100110101
011100000111000
110000101011100
100110010000011
111101001000010
001001010100101
101000010110100
011101011000010
011010101001100
010011101101110
101110111011011
110100011110001
111111101011000
111111000110101