011100101011110
110011001110111
010111111001101
011110001000101
001000111000010
011100011001110
111000001110111
111001010111110
010010100001111
010011001101011
100111111110101
100010111100100
110111111001011
010001110101111
011001111111100