100101111001001
100011001110110
111011111111101
000010011111110
111100110101011
111111011100111
110110110110111
100111110001111
000100010111000
100111010011110
010011110111011
011101100101011
011110110011010
101111011101001
111100011000110