111010100001111
011011000110010
111001010001100
001011110010011
110100110100101
100110100110011
011111011111100
111101110011101
101101001101101
010111100000110
100011011010011
101001011001010
111011001001100
110001011111011
100001010100110