011111101011011
111100001011001
110101001011000
001001011100000
111111101100110
001111100001010
110011001001100
001110100110010
010011001111001
001111101110101
010001010001101
111001000010100
111001110101110
010111110111111
011010001111111