111100100110011
100001010001001
001010101111001
110010110111010
001111111000010
000100001100100
010111100101001
111111100111011
011111100111111
100001110100100
010001110111110
111011111111010
100111101010111
010101110000110
111100011010011