111111011101110
000000100011111
111011100101111
110111111011011
011001000101000
001000101101110
110111100010101
111000001010100
011011110001011
001010011011000
100000110010010
110000000000111
100000100101100
101100000100111
111101010011100