100111101010111
110101010111100
011010011001000
100000011100111
110111001101100
000110111010001
101101100000010
011110001011011
001001101100110
010000110110111
111011101101101
010101110110001
100001111111011
010011011111000
011111111101101