001111011111111
111111111100110
111101110111110
110111110111001
000111000001101
100001010011010
011110001100001
100101011110011
101101010111111
010101000000010
110101000111000
000001000110110
111110100111001
011010011001100
101111000001000