010000110010101
000010001111000
110100000000000
010001110100010
010001100101010
010111000000110
011000110110000
110111011100001
010111111011110
111011101110101
010100011111011
011110110110110
101111010111010
100101011100000
011011100000111