111000101111101
100001010101101
011110010101100
010100010101011
110000111001001
110001101101110
100101000000110
000000101010111
101100111111010
100011010010011
100101011111010
011111111011100
001010001110111
011100000010101
000110000001100