011011111111100
100111010111111
011110111111111
110101111110000
111110100001110
011011111000110
011010111100101
010110000100100
011110110001111
000000111010001
111001011011110
010100110101101
101000010100000
111011001110111
001000101010011