001001110111010
010001101001100
101111111010011
010011111101100
100000011111110
100000001011111
101111011000001
011011001101011
100010011111111
000111011010100
011111001010101
011111010101101
111101111111001
110101110010001
110111110110100