001010101101111
000111101001101
010001100001100
000010111111101
111000110010001
110110111001010
111110010111100
011110111100101
110100000110000
111001101111101
011000011111110
000111110110101
010010110101000
011100110110110
100100011001010