010010111111000
011111111110111
011110111111111
011101010111100
100100101011011
000100101110110
010011011100110
010011011010010
111110100110011
100110100001100
010011101101001
100101010111010
111011110111010
011100111010100
100001110111011