000010111111111
010101001001000
111110100101000
000100001010010
000101110000011
011011110011010
011111010100111
111001111110110
110100000111011
010110001011001
101011000011001
001111001001101
110111110110110
011011010010101
101001111001101