001101100000111
001111111011111
000100100000101
001100011010001
100111111111000
011001000000101
011111111111100
101110011010111
000011001000110
011010101110100
110010011001110
110010111110110
010001111100000
111110000101000
100101000011111