011101111010100
101111000101000
011011111101111
000101101011111
001111111101111
110010010011010
011011011100011
010101011010100
000011111101101
011010011110111
000000110111001
001001110100101
110101010011000
000001010001000
110011111010000