111111111111001
011001101110110
001011100110010
110011101000111
010111111010010
100101010111010
011101000000100
100111001010100
001001011111100
001001100010011
000101110011011
101111000010011
100011100100111
100000110011001
111011100011011