101110111101010
110101001110111
001010100100100
000001010010011
101001010000111
001000111011100
011110101001110
110011000111101
000101001011100
010110000000111
100101010000100
011111000011111
010010101011000
000101000010110
111110111110011