111010001101000
001111101011110
011101000011101
001011000100110
110110111100100
100010110110001
110001000011100
000110110100001
110001111000100
111101000011011
100000010110110
011010111001010
111110110100111
011111000110101
111100100001100