110000101101110
011111000011100
011001111101011
000100001011110
101000100100011
010100000101110
101000101100000
011000000000101
100100111110001
110111100111000
000001111001111
110111000010101
101010110100001
110111100000010
111011110010011