000000101100110
100000111111111
111100100011100
001011011110101
100110111001001
011011001110011
110010110011011
100111111011001
111011100001011
100000110100011
111010100010000
011011011100101
010101101001000
001101100000011
000001001010101