010010101110000
011101111011111
100010100010001
010111111110111
111100001101000
110010111010010
001101011000101
100111011000011
011001100001100
010101111011011
110111010100111
101101101111111
000111111110110
000011011000000
111001011101101