101101010100000
100110000011101
100100100011000
010100101100000
010110101011001
011000011001011
111101000001011
101011001100100
000111110011011
101110101100010
000111010001101
111110111011111
000101011111000
010010101011000
101110011011111