101111110101000
100101010111110
000010100111111
111110110011110
010101010110000
101010011011110
111101110101101
111000010110101
101010101101001
001001000000000
000000011101000
110111101110100
010011100110111
110101000011000
001101111000110