011011011111110
101001110001001
110110000101000
111100100100011
110101011001110
101101011000000
110110110101011
110011001111101
100010110011010
110010001111001
110100110110101
110110100001110
101001101110110
011111000111100
101101111100010