111111110100010
000001111110101
101010001100011
010010001111110
101011001001101
111001101000100
010011100111111
110000101010100
010000011011010
001100111011111
001011111111101
111001101101000
110110000010100
100010010010001
001000010000101