001111010000011
001000111110100
010101110001101
101011000100110
000110101000101
101101110010110
011000001000110
111010000111110
100000000011001
011011011101011
111001111010101
110110111001001
101110110111101
001111011011110
101100110000111