001111111111110
010111101001101
011000000000011
111110000111111
100101000001110
011111100011111
000110000000110
011011011011011
101100111001010
100111001000011
111011100110110
001010100101000
010011101111010
100000111110010
001100100000011