101010100000000
100000101110010
000100001011000
011011110110101
011101001101110
110110110111101
101110011100111
100011010110111
011111000000001
101010000101000
010011100000000
110000000101011
111110100110100
010101111110000
111101011011010