100101100001011
101010001110010
001100100000101
101110010001010
101100111111101
111101100011011
010101000010101
001111100101001
001000011011110
000101111011001
010111111011001
101110100011001
010000110000001
000101000010111
101010101001110