011010100010001
101100000011100
111111111000110
110101100011010
100100110001001
010111110010111
001000110010101
110010100000011
101011100110011
000001011011111
110101110111011
100011101100100
001111110100111
001000010101100
110110011101111