000001110110000
110100011111110
001111110010011
111011111100010
111000001001010
111111111011101
011011101001111
010010000100001
110001011001010
001101011010111
111010010000000
111101111111110
111111110110101
111011101011111
111111100000101