111000111001001
100111001101110
111011001011011
011101101001001
000100010110110
001100001010011
111011010111111
100111100011011
011110100011101
111001011001011
100001001110010
001011100010101
111111000101010
011110110101101
000010001110011