001100100011110
101111001000101
000010000110011
110001111101101
010010110011110
000101011001000
001000001011111
101100011100000
011111111011011
001110100111011
101001101110000
010010011001011
101111100011111
010100101101001
111111110100000