100100010010001
000100100111011
010100011011000
011111111010101
001100111100110
010111111011110
011111100001111
011010011001011
111111000101001
001011100111110
110101001011000
101011010011110
111010110001001
010111111011100
011110011001101