111111111110010
111011001111001
010000111011111
000101111011101
001011011110101
101100000110111
000101011010000
110100111110110
110011010111101
110111010100101
000011000010000
000010001001101
111001000111100
010100111100001
100111111111101