111100111100111
100110111011111
100001101001111
000010110101101
010011100111101
101011000011010
110010011110011
000101001010101
101001111010111
000110101100011
001001110111101
110111110111000
001110010101110
010111010110011
101110000110101