101011000100011
001011011100001
111100100101101
111011000010000
100010111000010
110010001101000
110010101010100
110011101111111
011110010100001
101100001111001
010110000100011
010111110001101
101100101101001
110111110111110
111111011010010