101101111001001
111111010000111
100111111010111
010110000101111
110111111111111
100110101011100
110100000100000
111100110011111
100111000110111
000101101100011
101000101101001
001011010011101
001100101101100
100101010010011
010101100010110