111010110111000
101101111110011
111110110111100
001000111110001
011010101011011
101000111110111
111001000000001
000100101101101
100101110010101
000100010011111
111010111111101
110000010011101
101100001001010
100001111001010
110110000100100