010101110001100
110101011101011
011011010100100
101101100010000
111101100101100
011110101011101
101001001101011
111111110110111
101111010100100
111110010100001
001000001100000
101101000010010
010010101011100
001000011101000
010000010100001