110101011001000
111111101110111
011111110001000
111111110000111
100100110110111
010001010101111
100010110110101
100011011111111
101101001101010
101000110101110
010110111011111
010011011011001
001001010101011
010111100000001
100100101000110