110101001010001
011111010011011
011111101101110
100110111001110
111101101110111
000010111100001
100110100001010
011001010110110
100101110101111
000101001111001
010011100010011
111010110111110
011101110110011
010100011000000
001000110111110