101101111011111
011111101110111
111110110111010
100101110010110
000101011010110
101000001111011
011100011011011
101011000110111
111001010110100
001110101000011
111011111010111
100011110110000
100010011110001
000101101000010
011111001010111