010111000111000
001110101111001
011111000111000
101011101010000
110001010100011
100110001111111
111111111001010
001010111100100
001000111110000
101101000100001
011111110101001
111000101001110
111000011011001
100110010110101
101011101111001