100001000110100
011110111101110
000000011001000
111100001110100
100001000001000
111101000011101
110101101000000
000010011101011
100000100101000
101101001011011
000100100011111
101101110111101
111110011111001
110001111111101
111111000111100