11111000000000
01111000111000
00101100011000
01000111110000
01001110000000
01000100000000
00111000000000
00100000000000
00111111000000
00100000110000
00000000100000
00010011000000
00111110000000
00000111000000
00000010000000